#########
#P......#
#..###..#
#..#....#
#..#..#.#
#.....#.#
#..###..#
#......C#
#########