#############
#P......#...#
#.#####.#.#.#
#.....#.#.#.#
###.#.#.#.#.#
#C..#.#...#.#
#.#.#.#####.#
#.#.#.....#.#
#.#.#####.#.#
#.#.....#.#C#
#.#####.#.#.#
#...#......C#
#############