###########
#P........#
#..#####..#
#..#......#
#..#..###.#
#.....#...#
#.###.#...#
#...#.#...#
#...#..##.#
#........C#
###########