##############
#P.....#.....#
#.###..#.###.#
#...#..#...#.#
###.#..###.#.#
#...#......#.#
#.#####.####.#
#.....#......#
#.###.#.###.##
#C..#.#...#..#
#.#.#.###.#.C#
#.#.....#....#
#..#####....C#
##############