###########
#P........#
#..#####..#
#..#.C....#
#..#..#####
#.....#...#
#.###.#...#
#...#.....#
#...##.##.#
#.........#
###########