##########
#P.......#
#..####..#
#..#.....#
#..#..#..#
#.....#..#
#..####..#
#..#C....#
#.....#..#
##########